витамин	витамин	S
про	про	PR
пара	пара	S
тереть	тереть	V
система	система	S
брать	брать	V
стресс	стресс	S
детский	детский	A
кислота	кислота	S
основа	основа	S
железа	железа	S
цель	цель	S
фактор	фактор	S
спирт	спирт	S
новый	новый	A
медицинский	медицинский	A
смесь	смесь	S
бальза	бальза	S
молочная	молочная	S
зубной	зубной	S
капсула	капсула	S
старый	старый	A
грудной	грудной	A
красный	красный	S
минеральный	минеральный	A
золотой	золотой	S
экстракт	экстракт	S
успокоительный	успокоительный	A
сбор	сбор	S
желудочно	желудочный	A
слеза	слеза	S
сироп	сироп	S
виноград	виноград	S
никотин	никотин	S
нова	нова	S
баланс	баланс	S
вич	вич	A
изо	изо	PR
сыворотка	сыворотка	S
акт	акт	S
клеить	клеить	V
желчь	желчь	S
питательный	питательный	A
клещ	клещ	S
твердый	твердый	A
бульон	бульон	S
моркови	морковь	S
био	био	S
специальное	специальный	A
адреналин	адреналин	S
витаминный	витаминный	A
аква	аква	S
аллерген	аллерген	S
губка	губка	S
вакцина	вакцина	S
желудочный	желудочный	A
сердечный	сердечный	A
плоды	плод	S
сыворотки	сыворотка	S
гомеопатический	гомеопатический	A
гамма	гамма	S
бета	бета	S
моно	моно	COM
культура	культура	S
простата	простата	S
бадяга	бадяга	S
мак	мак	S
серный	серный	A
никотиновый	никотиновый	A
желчегонный	желчегонный	A
анти	анти	S
поверхностный	поверхностный	A
персиковое	персиковый	A
хмеля	хмелить	V
миг	миг	S
селить	селить	V
витаминно	витаминный	A
питательная	питательный	A
стимулятор	стимулятор	S
ультра	ультра	S
скин	скин	S
оригинальный	оригинальный	A
альф	альф	S
седативный	седативный	A
хвощ	хвощ	S
мочегонный	мочегонный	A
негр	негр	S
сосна	сосна	S
ким	ким	S
фито	фито	S
осадка	осадка	S
овес	овес	S
просыпать	просыпать	V
мятные	мятный	A
плазма	плазма	S
вита	вить	V
магне	магн	S
кузнецов	кузнец	S
этиловый	этиловый	A
микстура	микстура	S
нео	нео	S
депо	депо	S
прогестерон	прогестерон	S
присыпка	присыпка	S
ван	ван	S
ренни	ренни	S
рога	рог	S
бэби	бэби	S
коделак	коделак	S
искусственная	искусственный	A
комби	комби	S
конского	конский	A
джес	джес	S
чайное	чайный	A
растворитель	растворитель	S
слабительный	слабительный	A
микс	микс	S
бессмертник	бессмертник	S
эфир	эфир	S
ифа	ифа	S
бар	бар	S
березовые	березовый	A
антиген	антиген	S
камфорный	камфорный	A
лайф	лайф	S
цитрус	цитрус	S
лив	лить	V
гранулы	гранула	S
хай	хай	S
бронхо	бронхо	S
очищенная	очищать	V
успокой	успокаивать	V
отхаркивать	отхаркивать	V
плацента	плацента	S
ирс	ирс	S
этанол	этанол	S
витаминная	витаминный	A
мочевина	мочевина	S
тромбо	тромбо	S
индия	индий	S
алекс	алекс	S
хламидия	хламидия	S
дона	дон	S
бен	бен	S
урологический	урологический	A
оки	ока	S
кето	кето	S
алка	алка	S
джунгли	джунгли	S
ламинарии	ламинария	S
артра	артр	S
иов	иов	S
никс	никс	S
стрикс	стрикс	S
агри	агря	S
кокаина	кокаин	S
авиа	авиа	S
экс	экс	S
геп	геп	S
бриллиантовый	бриллиантовый	A
ляпис	ляпис	S
пиявка	пиявка	S
бриллиантового	бриллиантовый	A
лома	лом	S
бария	барий	S
туя	туя	S
лирика	лирик	S
снуп	снуп	S
пас	пас	S
адам	ада	S
рус	русый	A
саб	саба	S